{
    "0": [ "0x27" ],
    "1": [ "0x1E" ],
    "2": [ "0x1F" ],
    "3": [ "0x20" ],
    "4": [ "0x21" ],
    "5": [ "0x22" ],
    "6": [ "0x23" ],
    "7": [ "0x24" ],
    "8": [ "0x25" ],
    "9": [ "0x26" ],
    
    "'": [ "0x2D" ],
    "º": [ "0x35" ],
    "´": [ "0x34" ],
    ",": [ "0x1A" ],
    ".": [ "0x14" ],
    "-": [ "0x1D" ],
    "<": [ "0x64" ],
    ">": [ "0x64", "0xE1" ],
    
    "TAB": [ "0x2B" ],
    "BCKS": [ "0x2A" ],
    "CAPS": [ "0x39" ],
    "LSHI": [ "0xE1" ],
    "RSHI": [ "0xE5" ],
    "LCTR": [ "0xE0" ],
    "RCTR": [ "0xE4" ],
    "LALT": [ "0xE2" ],
    "RALT": [ "0xE7" ],
    "SPAC": [ "0x2C" ],
    "RET": [ "0x28" ],
    
    "A": [ "0x04" ],
    "B": [ "0x11" ],
    "C": [ "0x0C" ],
    "D": [ "0x0B" ],
    "E": [ "0x07" ],
    "F": [ "0x1C" ],
    "G": [ "0x18" ],
    "H": [ "0x12" ],
    "I": [ "0x0A" ],
    "J": [ "0x06" ],
    "K": [ "0x19" ],
    "L": [ "0x13" ],
    "M": [ "0x10" ],
    "N": [ "0x0F" ],
    "Ñ": [ "0x08" ],
    "O": [ "0x16" ],
    "P": [ "0x15" ],
    "Q": [ "0x1B" ],
    "R": [ "0x0D" ],
    "S": [ "0x33" ],
    "T": [ "0x0E" ],
    "U": [ "0x09" ],
    "V": [ "0x37" ],
    "W": [ "0x36" ],
    "X": [ "0x05" ],
    "Y": [ "0x17" ],
    "Z": [ "0x38" ]
}
